+                                +                                +                                 
+                                +                                +                                 
+++++++++++++++++++++++++++++++++++++++++++++++++++++++++++++++++++                                 
+   +     +            +         +         +   +   +    +         +                                 
+   +     +            +         +         +   +   +    +         +                                 
+   +     +            +         +         +   +   +    +++++++++++                                 
+   +     +            +         +++++++++++   +   +    +         +                                 
+   +     +            +         +         +   +   +    +++++++++++                                 
+   +     ++++++++++++++++++++++++         +   +   +    +         +                                 
+   +     +            +         +         +   +   +    +         +                                 
+   +     +            +         ++++++++++++++++++++++++++++++++++                                 
+   +     +            +         +         +   +   +    +         +                                 
+   +     ++++++++++++++++++++++++         +   +   +    +         +                                 
+   +     +            +         +         +   +   +    +         +                                 
+   +     +            +         +++++++++++   +   +    +++++++++++                                 
+   +     +            +         +         +   +   +    +         +                                 
+   +     ++++++++++++++++++++++++         +   +   +    +         +                                 
+   +     +            +         +         +   +   +    +         +                                 
+   +     +            +         +         +   +   +    +         +                                 
+++++++++++++++++++++++++++++++++++++++++++++++++++++++++++++++++++                                 
+   +    +    +    +    +    +   +   +   +   +    +   +           +                                 
+   +    +    +    +    +    +   +   +   +   +    +   +           +                                 
+   +    +    +    +    +    +   +   +   +   +    +   +           +                                 
+   +    +    +    +    +    +   +   +   +   +    +   +           +                                 
+   +    +    +    +    +    +   +   +   +   +    +   +           +                                 
+   +    +    +    +    +    +   +   +   +   +    +   + +++++++++++                                 
+   +    +    +    +    +    +   +   +   +   +    +   +           +                                 
+   +    +    +    +    +    +   +   +   +   +    +   +           +                                 
+   +    +    +    +    +    +   +   +   +   +    +   +           +                                 
+++++++++++++++++++++++++++++++++++++++++++++++++++   +           +                                 
+   +    +    +    +    +    +   +   +   +   +    +   +           +                                 
+   +    +    +    +    +    +   +   +   +   +    +   +           +                                 
+   +    +    +    +    +    +   +   +   +   +    +++++++++++++++++                                 
+   +    +    +    +    +    +   +   +   +   +    +   +           +                                 
+   +    +    +    +    +    +   +   +   +   +    +   +           +                                 
+   +    +    +    +    +    +   +   +   +   +    +   +           +                                 
+   +    +    +    +    +    +   +   +   +   +    +++++++++++++++++                                 
+   +    +    +    +    +    +   +   +   +   +    +   +           +                                 
+   +    +    +    +    +    +   +   +   +   +    +   +           +                                 
+++++++++++++++++++++++++++++++++++++++++++++++++++   +           +                                 
+   +    +    +    +    +    +   +   +   +   +    +   +           +                                 
+   +    +    +    +    +    +   +   +   +   +    +   +           +                                 
+   +    +    +    +    +    +   +   +   +   +    +++++++++++++++++                                 
+   +    +    +    +    +    +   +   +   +   +    +   +   +       +                                 
+   +    +    +    +    +    +   +   +   +   +    +   +   +       +                                 
+   +    +    +    +    +    +   +   +   +   +    +   +   +       +                                 
+   +    +    +    +    +    +   +   +   +   +    +   +   +++++++++                                 
+   +    +    +    +    +    +   +   +   +   +    +   +   +       +                                 
+   +    +    +    +    +    +   +   +   +   +    +   +   +       +                                 
+++++++++++++++++++++++++++++++++++++++++++++++++++   +   +       +                                 
+   +    +    +    +    +    +   +   +   +   +    +++++++++       +                                 
+   +    +    +    +    +    +   +   +   +   +    +   +   +       +                                 
+   +    +    +    +    +    +   +   +   +   +    +   +   +++++++++                                 
+   +    +    +    +    +    +   +   +   +   +    +   +   +       +                                 
+   +    +    +    +    +    +   +   +   +   +    +   +   +       +                                 
+   +    +    +    +    +    +   +   +   +   +    +   +   +       +                                 
+   +    +    +    +    +    +   +   +   +   +    +   +   +       +                                 
+   +    +    +    +    +    +   +   +   +   +    +   +   +       +                                 
+   +    +    +    +    +    +   +   +   +   +    +   +   +       +                                 
+++++++++++++++++++++++++++++++++++++++++++++++++++++++++++++++++++                                 
+              +                 +       +        +       +       +                                 
+              +                 +       +        +       +       +                                 
+              +                 +       +        +       +       +                                 
+              +                 +       +        +       +       +                                 
+++++++++++++++++++++++++++++++++++++++++++++++++++       +       +                                 
+              +                 +       +        +       +       +                                 
+              +                 +       +        +       +       +                                 
+              +                 +       +        +       +       +                                 
+              +                 +       +        +       +       +                                 
+++++++++++++++++++++++++++++++++++++++++++++++++++       +       +                                 
+              +                 +                +       +       +                                 
+              +                 +                +       +       +                                 
+              +                 +                +       +       +                                 
+              +                 +                +       +       +                                 
+++++++++++++++++++++++++++++++++++++++++++++++++++++++++++++++++++                                 
+              +                 +                +       +       +                                 
+              +                 +                +       +       +                                 
+              +                 +                +       +       +                                 
+              +                 +                +       +       +                                 
+++++++++++++++++++++++++++++++++++++++++++++++++++++++++++++++++++                                 
+              +        +        +                   +            +                                 
+              +        +        +                   +            +                                 
+              +        +        +                   +            +                                 
+              +        +        +                   +            +                                 
+++++++++++++++++++++++++++++++++++++++++++++++++++++++++++++++++++                                 
+                       +        +                   +            +                                 
+                       +        +                   +            +                                 
+                       +        +                   +            +                                 
+                       +        +                   +            +                                 
+++++++++++++++++++++++++++++++++++++++++++++++++++++++++++++++++++                                 
+         +   +    +    +        +                   +            +                                 
+         +   +    +    +        +                   +            +                                 
+         +   +    +    +        +                   +            +                                 
+         +   +    +    +        ++++++++++++++++++++++++++++++++++                                 
+         +   +    +    + ++++++++                   +            +                                 
+         +   +    +    +        +                   +            +                                 
+         +   +    +    +        +                   +            +                                 
+         +   +    +    +        +                   +            +                                 
+         +   +    +    +        +                   +            +                                 
++++++++++++++++++++++++++++++++++++++++++++++++++++++++++++++++++++++++++++++++++++++++++++++++++++
